25,12
###,,###,,,,,,,,,,,,,,,,,
# #,,#T#,,,,,,,,,,,,,,,,,
# #,,# #,,,,,,,,,,,,,,,,,
# #,,# ####,,,,,#######,,
# #,,#    #,,,,,#     #,,
# #,,# ## ###,,,#E### #,,
# #,,# ## =G#,,,# ### ###
# #### ##E###,,,#      O#
# WWWW ## #,,,,,# #######
# #### O  #,,,,,#T#,,,,,,
#R#,,######,,,,,###,,,,,,
###,,,,,,,,,,,,,,,,,,,,,,
1,1,0,0
10,6,DOOR,TOKEN,2,0
9,7,ENEMY,LINE,UP
17,5,ENEMY,WALL,RIGHT
6,1,TELEPORTER,1,2
17,9,TELEPORTER,2,1
