25,10
#########################
#R      #  O  #    #A  G#
# # ### # # # # ## #W####
#   ### # # # # ## #=####
# # ###   # #   ##     ##
# #     ### ###### ###  #
# # ###          #     H#
#   ### ### ###  #  #####
###O     #O            E#
,,#######################
11,6,0,0
20,3,DOOR,TOKEN,3,0
23,8,ENEMY,SMART,NULL
