14,9,2
#######,,,,,,,
#  #G #,,###,,
# ###=#### ###
#           O#
# ### ### ####
#K#,# #,#O#,,,
###,#-#,###,,,
,,,,#O#,,,,,,,
,,,,###,,,,,,,
1,3,18,0
2,3,ENEMY,LINE,LEFT
5,2,DOOR,TOKEN,3,0
1,5,KEY,RED
5,6,DOOR,KEY,RED,0